15 15
+ +-+-+-+-+-+-+-+-+-+-+-+-+-+-+
|# #|             |           |
+-+ + + +-+-+ +-+-+ +-+ +-+-+ +
| |#| |     | |     |   |     |
+ + +-+-+-+ +-+ +-+-+ +-+ +-+-+
| |# # # #|     |     | | |   |
+ +-+-+-+ + +-+-+ +-+-+ + + +-+
|   |# #|#| | |   |     | |   |
+-+ + + + + + + +-+-+ +-+ +-+ +
|   |#|# #| | |     |   | |   |
+ + + +-+-+ + +-+-+ + + + + + +
| | |# #| |   |   | | |     | |
+ +-+-+ + +-+ + + + + +-+-+-+ +
| |# # #|   |   | | | |   |   |
+ + +-+-+ +-+-+-+ + +-+ + + +-+
| |# # #|         |     | |   |
+ +-+-+ +-+-+-+-+ +-+-+-+ +-+-+
|   |# #|# #|# #|       |     |
+ + + +-+ + + + +-+ +-+-+-+ + +
| | |#|# #|# #|#|   |     | | |
+ + + + +-+-+-+ +-+-+ +-+ + + +
| | |# #| |   |# # #|   | | | |
+-+ +-+-+ + + +-+-+ + + + +-+ +
|   |       |     |#| | |     |
+ +-+ +-+-+-+-+-+ + +-+ +-+-+ +
| |   |         | |#|   |   | |
+ + +-+ +-+ +-+ + + + +-+ + +-+
|   |   |   |   | |#|     |   |
+ +-+-+-+ +-+ +-+ + +-+-+-+-+ +
|         |     |  # # # # # #|
+-+-+-+-+-+-+-+-+-+-+-+-+-+-+ +

