+ +-+-+-+-+-+
|# # #|     |
+-+-+ + +-+ +
|   |#| | | |
+-+ + + + + +
|   |#|   | |
+ +-+ +-+-+ +
|   |# # # #|
+ + +-+-+-+ +
| |       |#|
+ +-+-+ +-+ +
|     |    #|
+-+-+-+-+-+ +

