+ +-+-+-+-+-+-+
|# #|    # # #|
+-+ +-+-+ +-+ +
|# #|# # #|# #|
+ +-+ +-+-+ +-+
|#|# #|   |#| |
+ + +-+ +-+ + +
|# #|# # #|#| |
+-+-+ +-+ + + +
|# # #| |# #| |
+ +-+-+ +-+-+ +
|# #|         |
+-+ +-+-+-+-+ +
|  # # # # # #|
+-+-+-+-+-+-+ +

