4 4
+ +-+-+-+
|   |   |
+-+ +-+ +
| |     |
+ +-+-+ +
|       |
+ +-+-+-+
|       |
+-+-+-+ +