20 20
+ +-+-+-+-+-+-+-+-+-+-+-+-+-+-+-+-+-+-+-+
|# #| |       |       |       |  # # #| |
+-+ + + +-+ +-+ +-+ + + + +-+-+ + +-+ + +
|# #|     |     | | | | |       |#| |#| |
+ +-+-+-+-+ +-+-+ + +-+ +-+-+-+-+ + + + +
|# #|# # #|       |   |   |     |#|  # #|
+-+ + +-+ +-+-+-+-+ + +-+ + +-+ + +-+-+ +
| |# #|# #|# # # #| |   |   |   |# #|# #|
+ +-+-+ +-+ +-+-+ +-+ +-+ +-+-+-+-+ + +-+
|     |#|  #|   |# #|     |# # # # #|#| |
+-+-+ + + + + +-+-+ + +-+-+ +-+-+-+-+ + +
|   | |#| |#|     |#|     |#|   |# #|#| |
+ + + + +-+ + + +-+ + +-+-+ +-+ + + + + +
| | | |#|# #| |   |#| |# # #|   |#|#|# #|
+ + + + + +-+-+-+ + + + +-+-+ +-+ + +-+ +
| | | |# #|       |#| |#|     |# #|#  |#|
+ + + +-+-+-+ +-+ + +-+ +-+ +-+ +-+ +-+ +
| |   |     | |   |#|# #|   |# #| |# # #|
+ +-+ +-+ + + +-+-+ + +-+ +-+ +-+ +-+-+-+
| | |     |   |# #|# #|# # #|#|         |
+ + +-+-+-+-+ + + +-+-+ +-+ + + +-+-+-+ +
| |     |   | |#|# # # #| |# #| |       |
+ +-+ +-+ + + + +-+-+-+-+ +-+-+ +-+-+-+-+
| |   |   |   |# #|    # #|   |         |
+ + + + +-+-+-+-+ +-+-+ + +-+ + +-+-+-+ +
| | | |     |   |# # # #|#|   | |       |
+ + + +-+-+ + + +-+-+-+-+ + +-+ + +-+-+ +
| | | |   |   |     |# # #|     |   |   |
+ + +-+ + +-+-+-+ +-+ +-+-+-+-+ +-+ +-+-+
| |     |         |# #|  # # #|   |     |
+ +-+-+-+ +-+-+-+-+ +-+-+ +-+ +-+ +-+-+ +
|   |   |         |# # #|#| |#|   | |   |
+-+ + + +-+-+-+ +-+-+-+ + + + + +-+ + +-+
|   | | |   |   |     |# #|# #| |   |   |
+ +-+ + + + +-+-+ + + +-+-+ +-+ +-+ +-+ +
|     |   | |   | | | |   |#|     | |   |
+ +-+-+-+-+ + + + + + + +-+ +-+-+ + + +-+
|   |     |   | | | |   |# #|# #|   |   |
+-+ +-+ + +-+-+ + + +-+-+ +-+ + +-+-+-+ +
|       |     |   |      # # #|# # # # #|
+-+-+-+-+-+-+-+-+-+-+-+-+-+-+-+-+-+-+-+ +

